11111111111111111111111
1P0001000000010C00001C1
10100110001000001010111
10100100111111101010011
100000000000C00000E0001
100001100C1000001000011
11111111111111111111111