11111111111111111111111
1P0001000000010C00000C1
10100110001000001010011
10100100111111101010011
111000000000C0000000001
1E1001100C1000001000011
11111111111111111111111