11111111111111111111111

10100110001000001010011
10100100111111101010011
100000000000C00000E0001
100001100C1000001000011
11111111111111111111111