1111111111111111111111111111111111111111
1E0000000000010C00000C00000000P000000001
1010010100100000101001000000010101000101
1010010010101010001001000000010101000101
100000000C00C0000000000000000000000000C1
1010010100101010010100101001010010100101
1010010010101010001001000000010101000101
1010010100101000101001000000010101000101
1C000E0000C00C000000000000000000000000C1
1111111111111111111111111111111111111111