111111111111111111111111111
1P100001C000C00100001000001
1C000101111100011101100T011
10111101000000C001110001001
10000101000010110000C011001
1C111100010TC0100001111C001
1010T001011100100100C1T0011
10111C0100T0001011000101001
1010CC0111110110100111010C1
1C1010000000010010010001111
10111111000101011E010000001
1000C0011100010C11111110101
111111111111111111111111111