111111111111111111111111111
1P100001C000C00100001000001
1C0001011111000111011000011
10111101000000C001110001001
10000101000010110000C011001
1C1111000100C0100001111C001
10100001011100100100C100011
10111C010000001011000101001
1010CC0111110110100111010C1
1C1010000000010010010001111
10111111000101011E010000001
1000C0011100010C11111110101
111111111111111111111111111