11111111111111111111111
1P000100000001000000001
10100110001000001010011
10100100111111101010011
100000000000000000E0001
10000110001000001000011
11111111111111111111111